3 3 3 3 3 3 3 3 3 3 3 3 3 3 3 3 3 3 3 3 3 3 3 3 3 3 3 3 3 3 3 3 3 3 3 3 3 3 3 3 3 3 3 3 3 3 3 3 3 3
3 4 4 4 4 4 4 4 4 4 4 4 4 4 4 4 4 4 4 3 3 3 3 3 3 3 3 3 4 4 4 4 4 4 4 4 4 4 4 4 4 4 4 4 4 4 4 4 4 3
3 4 4 4 4 4 4 4 4 4 4 4 4 4 4 4 4 4 4 3 2 2 2 2 2 2 2 3 4 4 4 4 4 4 4 4 4 4 4 4 4 4 4 4 4 4 4 4 4 3
3 4 4 4 4 4 4 4 4 4 4 4 4 4 4 4 4 4 4 3 2 2 2 2 2 2 2 3 4 4 4 4 4 4 4 4 4 4 4 4 4 4 4 4 4 4 4 4 4 3
3 4 4 4 0 4 4 4 4 4 4 4 4 4 4 4 4 4 4 3 2 2 2 2 2 2 2 3 4 4 4 4 4 4 4 4 4 4 4 4 4 4 4 4 4 4 4 4 4 3
3 4 4 4 4 4 4 3 3 3 3 3 3 3 4 4 4 4 4 3 2 2 2 2 2 2 2 3 4 4 4 4 4 4 4 4 4 4 4 4 4 4 4 4 4 4 4 4 4 3
3 4 4 4 4 4 4 3 1 1 1 1 1 3 4 4 4 4 4 3 2 2 2 2 2 2 2 3 4 4 4 4 4 3 3 3 3 3 3 3 3 3 3 4 4 4 4 4 4 3
3 4 4 4 4 4 4 3 1 2 2 2 1 3 4 4 4 4 4 3 5 5 5 5 5 5 5 3 4 4 4 4 4 3 5 5 5 5 5 5 5 4 3 4 4 4 4 4 4 3
3 4 4 4 4 4 4 3 1 2 2 2 1 3 4 4 4 4 4 3 3 5 5 5 5 5 5 3 4 4 4 4 4 3 5 5 5 5 5 5 5 5 3 4 4 4 4 4 4 3
3 4 4 4 4 4 4 3 1 2 2 2 1 3 4 4 4 4 4 3 3 3 5 5 5 3 3 3 4 4 4 4 4 3 5 5 5 5 5 5 5 5 3 4 4 4 4 4 4 3
3 4 4 4 4 4 4 3 1 2 2 2 1 3 4 4 4 4 4 4 4 3 3 5 5 3 3 4 4 4 4 4 4 3 5 5 5 5 5 5 5 5 3 4 4 4 4 4 4 3
3 4 4 4 4 4 4 3 1 1 0 1 1 3 4 4 4 4 4 4 4 4 3 5 5 3 4 4 4 4 4 4 4 3 5 5 5 5 5 5 5 5 3 4 4 4 4 4 4 3
3 4 4 4 0 0 4 3 3 0 0 3 3 3 4 4 4 4 4 4 4 4 3 5 5 3 4 4 4 4 4 4 4 3 4 5 5 5 5 5 5 4 3 4 4 4 4 4 4 3
3 4 4 4 4 4 4 4 4 0 0 4 4 4 4 4 4 4 4 4 4 4 3 5 5 3 4 4 4 4 4 4 4 3 3 3 3 5 5 3 3 3 3 4 4 4 4 4 4 3
3 4 4 4 4 4 4 4 4 0 0 4 4 4 4 4 4 4 4 4 4 4 3 5 5 3 4 4 4 4 4 4 4 4 4 4 4 0 5 4 4 4 4 4 4 4 4 4 4 3
3 4 4 4 4 4 4 4 0 0 0 4 4 4 4 4 4 4 4 4 4 4 3 5 5 3 4 4 4 4 4 4 4 4 4 4 4 0 5 4 4 4 4 4 4 4 4 4 4 3
3 4 4 4 4 4 4 0 0 0 0 4 4 4 4 4 4 4 4 4 4 4 3 5 5 3 4 4 4 4 4 4 4 4 4 4 4 0 5 4 4 4 4 4 4 4 4 4 4 3
3 4 4 4 4 4 4 0 0 4 4 4 4 4 4 4 4 4 4 4 4 4 3 5 5 3 4 4 4 4 4 4 4 4 4 4 4 0 5 4 4 4 4 4 4 4 4 4 4 3
3 4 4 4 5 5 4 0 0 4 4 4 4 4 4 4 4 4 4 4 3 3 0 5 0 3 3 4 4 4 4 4 4 4 4 4 5 5 5 4 4 4 4 4 4 4 4 4 4 3
3 4 4 4 4 4 4 0 0 4 4 4 4 4 4 4 4 4 4 4 3 0 0 5 0 0 3 3 4 4 4 4 4 0 0 0 5 0 0 4 4 4 4 4 4 4 4 4 3 3
3 4 4 4 4 4 4 0 0 4 4 0 0 0 0 0 0 0 0 0 0 0 0 5 0 0 0 0 0 0 0 0 0 0 5 5 0 0 0 4 4 4 4 4 4 4 4 4 3 3
3 4 4 4 0 4 4 0 0 4 4 5 5 5 5 5 5 5 5 5 5 5 5 5 5 5 5 5 5 5 5 5 5 5 5 5 5 5 4 4 4 4 4 4 4 4 4 4 4 3
3 4 4 4 4 4 4 0 0 4 4 0 0 0 0 0 0 0 0 0 0 0 0 5 0 0 0 0 0 4 4 4 4 4 4 4 5 5 4 4 4 4 4 4 4 4 4 4 4 3
3 4 4 4 4 4 4 0 0 4 4 0 0 4 4 4 4 4 4 3 3 0 0 5 0 0 3 4 4 4 4 4 4 4 4 4 5 5 4 4 4 4 4 4 4 4 4 4 4 3
3 4 4 4 4 4 4 0 0 4 4 0 0 0 0 4 4 4 4 4 3 3 0 5 0 3 4 4 4 4 4 4 4 4 4 4 5 5 4 4 4 4 4 4 4 4 4 4 4 3
3 4 4 4 4 4 4 0 0 0 4 0 0 0 0 4 4 4 4 4 4 3 0 5 3 3 4 4 4 4 4 4 4 4 4 4 5 5 4 4 4 4 4 0 4 4 4 4 4 3
3 4 4 4 0 4 4 0 0 0 4 4 4 0 0 4 4 4 4 4 4 4 5 5 4 4 4 4 4 4 4 4 4 4 4 4 5 5 4 4 4 4 4 0 5 4 4 4 4 3
3 4 4 4 4 4 4 4 0 0 4 4 4 0 0 4 4 4 4 4 4 4 5 5 4 4 4 0 4 4 4 4 4 4 4 0 5 5 4 4 4 4 4 5 5 5 4 4 4 3
3 4 4 4 4 4 4 3 0 0 3 3 3 0 0 3 4 4 4 0 4 4 5 5 4 4 4 4 0 4 0 4 4 4 4 4 5 5 4 4 4 4 4 5 5 4 4 4 4 3
3 4 4 4 4 0 4 3 0 0 0 0 0 0 0 3 4 4 4 4 4 4 5 5 4 4 0 4 0 4 0 4 4 4 4 4 5 5 4 4 4 4 4 4 4 4 4 4 4 3
3 4 4 4 4 4 4 3 0 0 0 0 0 0 0 3 4 4 4 0 4 4 5 5 4 4 4 4 4 4 4 4 4 4 4 4 0 0 4 4 4 4 4 4 4 4 4 4 4 3
3 4 4 4 0 4 4 3 0 0 0 0 0 0 0 3 4 4 4 4 4 4 5 5 4 4 4 4 4 4 4 4 4 4 4 0 0 0 4 4 4 4 4 4 4 4 4 4 4 3
3 4 4 4 0 4 4 3 0 0 0 0 0 0 0 3 4 0 0 4 0 4 5 5 4 4 4 4 0 0 0 4 4 4 4 0 0 0 4 4 4 4 4 4 4 4 4 4 4 3
3 4 4 4 0 4 4 3 0 0 0 0 0 0 0 3 4 4 4 4 4 4 5 5 4 4 4 4 4 4 4 4 4 4 4 0 0 0 4 4 4 4 4 4 4 4 4 4 4 3
3 4 4 4 4 4 4 3 0 0 0 0 0 0 0 3 4 4 4 4 4 4 5 5 4 4 4 4 4 4 0 4 4 4 4 0 0 0 4 4 4 4 4 4 0 1 4 4 4 3
3 4 4 4 4 4 4 3 3 3 3 3 3 3 3 3 4 3 3 3 3 3 5 5 3 3 3 3 3 3 3 3 3 3 3 0 0 0 3 3 4 4 4 4 4 1 1 4 4 3
3 4 4 4 4 4 4 4 4 4 4 4 4 4 4 4 4 3 4 0 0 0 0 0 0 0 0 4 4 4 4 4 4 4 0 0 0 0 0 3 4 4 4 4 1 1 1 4 4 3
3 4 4 4 4 4 4 4 0 0 4 4 4 4 0 0 4 3 0 0 0 0 0 0 0 0 0 0 4 4 0 4 4 0 0 0 0 0 0 3 4 4 4 4 4 4 4 4 4 3
3 4 4 4 4 4 4 4 4 4 4 4 0 0 0 0 4 3 0 0 0 0 0 0 0 0 0 0 4 4 4 4 0 0 0 0 0 0 0 3 4 4 4 4 4 4 4 4 4 3
3 4 4 4 4 4 4 4 4 4 4 4 4 0 4 4 4 3 0 0 0 0 0 0 0 0 0 0 0 4 4 4 0 0 0 0 0 4 0 3 4 4 4 4 4 4 4 4 4 3
3 4 4 4 4 4 4 4 4 4 4 4 4 4 4 4 4 3 0 0 0 0 0 0 0 0 0 0 0 0 0 0 0 0 4 0 0 0 0 3 4 4 4 4 4 4 4 4 4 3
3 4 4 4 4 4 4 4 4 4 4 4 4 0 4 4 4 3 4 0 0 0 0 0 0 0 0 0 0 0 0 0 0 0 0 0 0 0 0 3 4 4 4 4 4 4 4 4 4 3
3 4 4 4 4 4 4 4 4 4 4 4 4 4 4 4 4 3 4 4 0 0 0 0 0 0 4 3 3 3 3 0 0 4 0 0 4 0 0 3 4 4 4 4 4 4 4 4 4 3
3 4 4 4 4 4 4 4 4 4 4 4 4 4 4 4 4 3 3 3 3 3 3 3 3 3 3 3 4 4 3 4 0 0 0 0 0 0 4 3 4 4 4 4 4 4 4 4 4 3
3 4 4 4 4 4 4 4 4 4 4 4 4 4 4 4 4 4 4 4 4 4 4 4 4 4 4 4 4 4 3 3 3 3 3 3 3 3 3 3 4 4 4 4 1 1 1 4 4 3
3 4 4 4 4 4 4 4 4 4 4 4 4 4 4 4 4 4 4 4 4 4 4 4 4 4 4 4 4 4 4 4 4 4 4 4 4 4 4 4 4 4 1 4 4 1 4 4 4 3
3 4 4 4 4 4 4 4 4 4 4 4 4 4 4 4 4 4 4 4 4 4 4 4 4 4 4 4 4 4 4 4 4 4 4 4 4 4 4 4 4 4 1 4 4 4 4 4 4 3
3 4 4 4 4 4 4 4 4 4 4 4 4 4 4 4 4 4 4 4 4 4 4 4 4 4 4 4 4 4 4 4 4 4 4 4 4 4 4 4 4 4 4 4 4 4 4 4 4 3
3 4 4 4 4 4 4 4 4 4 4 4 4 4 4 4 4 4 4 4 4 4 4 4 4 4 4 4 4 4 4 4 4 4 4 4 4 4 4 4 4 4 4 4 4 4 4 4 4 3
3 3 3 3 3 3 3 3 3 3 3 3 3 3 3 3 3 3 3 3 3 3 3 3 3 3 3 3 3 3 3 3 3 3 3 3 3 3 3 3 3 3 3 3 3 3 3 3 3 3